22.............22
22.............22
.................
2...............2
2.32.........23.2
23322.......22332
23322.......22332
22..2.......2..22
22.............22
...33322222333...
..2333.....3332..
...3....4....3...
55332.44444.23355
55332.44444.23355
...3....4....3...
..2333.....3332..
...33322222333...
22.............22
22..2.......2..22
23322.......22332
23322.......22332
2.32.........23.2
2...............2
.................
22.............22
22.............22
