4433.........3344
4433.........3344
44.............44
......22222......
223333.....333322
223333.....333322
333333.222.333333
.......242.......
.......222.......
..5..33...33..5..
.555.33...33.555.
..5...........5..
.222..44444..222.
..5...........5..
.555.33...33.555.
..5..33...33..5..
.......222.......
.......242.......
333333.222.333333
223333.....333322
223333.....333322
......22222......
44.............44
4433.........3344
4433.........3344