222...........222
42433.......33424
42433.......33424
22233.......33222
.......222.......
.555...222...555.
.555.........555.
.555.3333333.555.
.......333.......
33333.......33333
2222.........2222
2332...444...2332
2332....4....2332
2332...444...2332
2222.........2222
33333.......33333
.......333.......
.555.3333333.555.
.555.........555.
.555...222...555.
.......222.......
22233.......33222
42433.......33424
42433.......33424
222...........222